# Map converted by mapmapper
# @(#)$Id: labyrinth.map,v 1.1 1994/02/23 14:40:13 jkh Exp $ Version 1.0
mapWidth:            170
mapHeight:           130
mapName:             The Labyrinth
mapAuthor:           Ronny H. Arild
teamPlay:            no
timing:              no
mapData: \multiline: EndOfMapdata
xxxxxxxxxxxxxxxxxxxxxxxxxxxxxxxxxxxxxxxxxxxxxxxxxxxxxxxxxxxxxxxxxxxxxxxxxxxxxxxxxxxxxxxxxxxxxxxxxxxxxxxxxxxxxxxxxxxxxxxxxxxxxxxxxxxxxxxxxxxxxxxxxxxxxxxxxxxxxxxxxxxxxxxxxx
x                                                                                                                                                                        x
x                                                                                                                                                                        x
x                                                                                                                                                                        x
x                                                                                                                                                                        x
x                                                                                                                                                                        x
x                                                                                                                                                                        x
x                                                                                                                                                                        x
x                                                                                                                                                                        x
x                                                                                                                                                                        x
x         qxxxxxxxxxw                   q         qxxxxxxxxxxxxxxxxxxxw         qxxxxxxxxxxxxxxxxxxxxxxxxxxxxxw         q         w         axxxxxxxxxw        q         x
x         x         x                   x         x                   x         x                             x         x         x                   x        x         x
x         x         x                   x         x                   x         x                             x         x         x                   x        x         x
x         x         x                   x         x                   x         x                             x         x         x                   x        x         x
x         x         x                  dx         xf                  x         x        qw                   x         x         x                   x        x         x
x         x         x                   x         x                   x         x        as                   x         x         x                   x        x         x
x         x         x                   x         x                   x         x                             x         x         x                   x        x         x
x         x         x                   x         x                   x         x                             x         x         x                   x        x         x
x         x         x  r                x         x                   x         x                            #x         x         x                   x        x         x
x         x         axxxxxxxxxxxxxxxxxxxs         x         w         x         x         axxxxxxxxxxxxxxxxxxxs         x         axxxxxxxxxw         x        x         x
x         x                                       x         x         x         x                                       x                   x         x        x         x
x         x                                       x         x         x         x                                       x                   x         x        x         x
x         x                                       x         x         x         x                                       x                   x         x        x         x
x         x                                       x         x         x         x                                       x                   x         x        x         x
x         x                                       x         x         x         x                                       x                   x         x        x         x
x         x                                       x         x         x         x                                       x                   x         x        x         x
x         x                                       x         x         x         x                                       x                   x         x       dx         x
x         x                                       x         x         x         x                                       x                   x         x        x         x
x         x                                       x         x         x         x                                       x                 _ x         x        x         x
x         axxxxxxxxxxxxxxxxxxxxxxxxxxxxxxxxxxxxxxxs         x         x         axxxxxxxxxxxxxxxxxxxxxxxxxxxxxw         axxxxxxxxxxxxxxxxxx#s         a        x         x
x                                                           x         x                                                                                        x         x
x                                                           x         x                                                                                        x         x
x                                                           x         x                                                                                        x         x
x                                                           x         x                                                                                        x         x
x                                                           x         x                                                                                        x         x
x                                                           x         x                                                                                        x         x
x                                                           x         x                                                                                        x         x
x                                                           x         x                                                                                        x         x
x                                                           x r       x                                                                                        x         x
x         qxxxxxxxxxxxxxxxxxxxxxxxxxxxxxw         q         axxxxxxxxxs         qxxxxxxxxxxxxxxxxxxxxxxxxxxxxxw         qxxxxxxxxxxxxxxxxxxxxxxxxxxxxxxxxxxxxxxs         x
x         x                             x         x              c              x                             x         x                                                x
x         x                             x         x                             x                             x         x                                                x
x         x                             x         x                             x                             x         x                                                x
x         x                             x         x                             x                             x         x                                                x
x         x                             x         x                             x                             x         x                                                x
x         x                             x         x                             x                             x         x                                                x
x         x                             x         x                             x                             x         x                                                x
x         x                             x         x                             x                             x         x                                                x
x         x                             x         x                             x                             x         x                                  r             x
x         x    q    qxxxxxxxxxw         a         axxxxxxxxxxxxxxxxxxxw         x         qxxxxxxxxxw         x         x         qxxxxxxxxxxxxxxxxxxxxxxxxxxxxw         x
x         x    x    x                                                           x         x         x         x         x         x                            x         x
x         x    x    x                                                           x         x         x         x         x         x                            x         x
x         x    x    x                                                           x         x   rrr   x         x         x         x                            x         x
x         x    x    x                                                           x         x  d###f  x         x         x         x                            x         x
x         x    #    x                                                           x         x  d#x#f  x         x         x         x                            x         x
x         x    x    x                                                           x         x  d###f  x         x         x         x                            x         x
x         x    x    x                                                           x         x   ccc   x         x         x         x                            x         x
x         x    x    x                                                           x         x         x         x         x         x                            x         x
x         x _  x  _ x                                                           x         x         x         x         x         x                            x         x
x         axxxxxxxxxs         qxxxxxxxxxxxxxxxxxxxxxxxxxxxxxxxxxxxxxxxxxxxxxxxxxx         x     axxxs         x         x         x         qxxxxxxxxxw        x         x
x                             x                                                 x         x                   x         x         x         x         x        x         x
x                             x                                                 x         x                   x         x         x         x         x        x         x
x                             x                                                 x         x                   x         x         x         x         x        x         x
x                             x                                                dx         x                   x         x         x         x         x        x         x
x                             x                                                 x         x                   x         x         x         x         x        x         x
x                             x                                                 x         x                   x         x         x         x         x        x         x
x                             x                                                 x         x                   x         x         x         x         x        x         x
x                             x                                                 x         x                   xf        x         x         x         x        x         x
x                             x                                                 x         x                   x         x         x         x         x        x         x
x         qxxxxxxxxxxxxxxxxxxxs         qxxxxxxxxxxxxxxxxxxxxxxxxxxxxxw         x         axxxxxxxxxxxxxxxxxxxs         x         x         x         x        s         x
x         x                             x                             x         x                                       x         x         x         x                  x
x         x                             x                             x         x                                       x         x         x         x                  x
x         x                             x                             x         x                                       x         x         x         x                  x
x         x       r                     x                             x         x                                       x         x         x         x                  x
x         x      d#f                    x                             x         x                                       x         x         x         x                  x
x         x       c                     x                             x         x                                       x         x         x         x                  x
x         x                             x                             x         x                                       x         x         x         x                  x
x         x                             x                             x         x                                       x         x         x         x                  x
x         x                             x                             x         x  r                                    x         x         x         x                  x
x         axxxxxxxxxxxxxxxxxxxxxxxxxxxxxs         qxxxxxxxxxw         x         xxxxxxxxxxxxxxxxxxxxxxxxxxxxxxxxxxxxxxxxs         x         x         axxxxxxxxw         x
x                                                 x         x         x         x              c                                  x         x                  x         x
x                                                 x         x         x         x                                                 x         x                  x         x
x                                                 x         x         x         x                                                 x         x                  x         x
x                                                 x         x         x         x                                                 x         x                  x         x
x                                                 x         x         x         x                                                 x         x                  x         x
x                                                 x         x         x         x                                                 x         x                  x         x
x                                                 x         x         x         x                                                 x         x                  x         x
x                                                 x         x         x         x                                                 x         x                  x         x
x                                                 x _       x         x         x                                                 x         x                _ x         x
x         qxxxxxxxxxxxxxxxxxxxs                   a#xxs     x         x         a         qxxxxxxxxxxxxxxxxxxxxxxxxxxxxxxxxxxxxxxxs         a         qxxxxxxx#s         x
x         x                                                 x         x                                                                               x                  x
x         x                                                 x         x                                                                               x                  x
x         x                                                 x         x                                                                               x                  x
x         x                                                 x         x                                                                               x                  x
x         x                                                 x         x                                                                               x                  x
x         x                                                 x         x                                                                               x                  x
x         x                                                 x         x                                                                               x                  x
x         x                                                 x         x                                                                               x                  x
x         x                                                 x         x                                                              r                x                  x
x         x         qxxxxxxxxxw         qxxxxxxxxxxxxxxxxxxxs         x         axxxxxxxxxxxxxxxxxxxw         q         axxxxxxxxxxxxxxxxxxxw         x        w         x
x         x         x                   x                             x                             x         x                             x         x        x         x
x         x         x                   x                             x                             x         x                             x         x        x         x
x         x         x                   x                             x                             x         x                             x         x        x         x
x         x         x                   x                             x                           _ x         x                             x         x        x         x
x         x         x                   x                             x                         qxxxx         x                             x         x        x         x
x        dx         x                   x                             x                             x         x                             x         x        x         x
x         x         x                   x                             x                             x         x                             x         x        x         x
x         x         x                   x                             x                             x         x                             x         x        x         x
x         x         x                   x                             xf                          _ x         x                             x         x        x         x
x         axxxxxxxxxs         qxxxxxxxxxs         qxxxxxxxxxxxxxxxxxxxs         qxxxx#xxxxxxxxxxxxxxx         x         qxxxxxxxxxw         x         x        x         x
x                             x                   x                                                 x         x                 d#x         x         x        x         x
x                             x                   x                                                 x         x                  cx         x         x        x         x
x                             x                   x                                                 x         x                   x         x         x        x         x
x                             x                   x                                               _ x         x                   x         x         x        x         x
x                             x                   x                                             axxxx         x                   x         x         x        x         x
x                             x                   x                                                 x         x                   x         x         x        x         x
x                             x                   x                                                 x         x                   x         x         x        x         x
x                             x                   x                                                 x         x                   x         x         x        x         x
x                             x                   x                                               _ x         x                   x         x         x        x         x
x         axxxxxxxxxxxxxxxxxxxs         qxxxxxxxxxs         qxxxxxxxxxxxxxxxxxxxxxxxxxxxxxxxxxxxxxxxs         axxxxxxxxxxxxxxxxxxxs         a         axxxxxxxxs         x
x                 c                                                                                                                                                      x
x                                                                                                                                                                        x
x                                                                                                                                                                        x
x                                                                                                                                                                        x
x                                                                                                                                                                        x
x                                                                                                                                                                        x
x                                                                                                                                                                        x
x                                                                                                                                                                        x
x                                                                                                                                                              r         x
xxxxxxxxxxxxxxxxxxxxxxxxxxxxxxxxxxxxxxxxxxxxxxxxxxxxxxxxxxxxxxxxxxxxxxxxxxxxxxxxxxxxxxxxxxxxxxxxxxxxxxxxxxxxxxxxxxxxxxxxxxxxxxxxxxxxxxxxxxxxxxxxxxxxxxxxxxxxxxxxxxxxxxxxxx
EndOfMapdata
