# Map converted by mapmapper @(#)Version 1.0

mapWidth:            100
mapHeight:           100
mapName:             Legend
mapAuthor:           nelson@reed.edu
crashWithPayer:      yes
playerKillings:      yes
playerShielding:     yes
limitedVisibility:   no
teamPlay:            no
timing:              no
onePlayerOnly:       no
limitedLives:        no
worldLives:          0
mapData: \multiline: EndOfMapdata
xxxxxxxxxxxxxxxxxxxxxxxxxxxxxxxxxxxxxxxxxxxxxxxxxxxxxxxxxxxxxxxxxxxxxxxxxxxxxxxxxxxxxxxxxxxxxxxxxxxx
x                                                                                                  x
x                                                                                                  x
x                                                                                                  x
x                                                                    _         qw                  x
x               _                                                   xx         as     r            x
x              qxw                 qxxxxxw                          #x                xx     qw    x
x              xxx       xw        ax#xxxs                                            xx     as    x
x        r     axxw      xxf           ax                                 r                        x
x        x      #xx      xx             xw                                x                        x
x        x      axs      axxw           xx          q#x                                            x
x       qx                axxxw         as        qxxxx        xxx                                 x
x       x#                dxxxxxx                 axxxx       dxxx               qw                x
x       xx                   axs                               xxx               as       _        x
x      qxxw                                                            qw                 xxx      x
x    xxxxxx                                                            as                 xxx      x
x    as axs                                                                               xxx      x
x                                                                                                  x
x             qxxw                                                            xx                   x
x             axxx                 qx#xw                                      xx     x             x
x              axx              xxxxxxxxf                   r                                      x
x               xx              axxxxxxs      qw           qxw                                     x
x    qx         xxw    qw        axs         qxx           axx                              dxx    x
x   qxxw        axs    xx                    xxs            as           xxx                 xx    x
x xxxxx#               x#                     c                         dxxx         qxw           x
x  axxxs               xxw                                               xxx         xxx           x
x   axx                xxx                                                           axs           x
x    xx                axxw                                                                        x
x    xs                 axxw                         xw                                            x
x    x                   axx                        qxx          _                                 x
x    x                    xx         _qxxw         qxxs          xx                           x    x
x    x                    as        qxxxxx        dxx            #x           qw                   x
x    c                              axxxxs                                    as                   x
x          _  qxw                    a#xs                                              xx          x
x        xxxx#xxx                                                                      xx          x
x        axxs axs                                                                       c          x
x                                                                       r                          x
x                                                          qx          qxw                         x
x                                                          xx         dxxxf                        x
x                     qxw                                   c          axs         qw              x
x                     a#xw                                              c          as       qw     x
x                      axs             qxxw                                                 as     x
x     qw                c            dxxxxx                                                        x
x    dxxw                             ax#xs                                                        x
x     axxxw                                                                                        x
x      axxs                                                                                        x
x                                                                                                  x
x                  w                                                xx                             x
x                  xw                                               xx                             x
x                  ax           qxw                                 x                              x
x                               xxx                <                x           qw                 x
x          xs                   axs                                 x           axxxx              x
x          s                                                        x                      xx      x
x                                                                                          xx      x
x                                                                                           x      x
x                                                                                           x      x
x    qx         xxf                   qw                                                    x      x
x    xs         as                    xx                                                    x      x
x                         qw           x                                   dxxxxx#                 x
x                         xs                                                                       x
x                                                         xxx                                      x
x                                                                  xxxxx                           x
x           x                                                                         _            x
x                               x                                                   xxxx           x
x                                                                                           r      x
x      x          x                                   r                                     x      x
x                                            x        x                                     x      x
x                       x                             x     #     x       x                 x      x
x                                                     x     x     x       x                        x
x                                      x                    x     x       x                        x
x          x                  #                                   x       x     xxxxxf             x
x               x                                                 x       x                        x
x    x                                                                    x                        x
x                   x                          dxxx                                    xxxxxx      x
x                                                                                                  x
x            #            _       dx                               dxx                             x
x                         x                               x                xxxx                    x
x                                                         x                                        x
x         x     r                                         x                                   r    x
x    dx         x                          xx             x     _      x      r       _       x    x
x                    x                                         xxxx    x      x    xxxxxxx    x    x
x                    c        x                                        x      x               x    x
x            x                c                                        x                      x    x
x  x                                                                   x                      x    x
x                                     r                                                            x
x               dx    x               x                   dxxxx              xxxx#xx               x
x      x                    x                x                                                     x
x          _                                 x       x                                             x
x          x                                         x           r                       xxxxx     x
x                                                    x           x     xxxx                        x
x                      x          x                              x             x                   x
x   x           x                                                #             x                   x
x        #                  x            x               x       x             x     xxxxxf        x
x                                               xx       x       x             x                   x
x            x      x            _                       x       x             x                   x
x     x                  x       x                                             c                   x
x                                                                                                  x
x                                                                                                  x
x                                                                                                  x
xxxxxxxxxxxxxxxxxxxxxxxxxxxxxxxxxxxxxxxxxxxxxxxxxxxxxxxxxxxxxxxxxxxxxxxxxxxxxxxxxxxxxxxxxxxxxxxxxxxx
EndOfMapdata
