# Map converted by mapmapper @(#)Version 1.0

mapWidth:            100
mapHeight:           100
mapName:             Padded Room
mapAuthor:           Dave Lemke
crashWithPayer:      yes
playerKillings:      yes
playerShielding:     yes
limitedVisibility:   yes
teamPlay:            no
timing:              no
onePlayerOnly:       no
limitedLives:        no
worldLives:          0
gravity:	     0
mapData: \multiline: EndOfMapdata
xxxxxxxxxxxxxxxxxxxxxxxxxxxxxxxxxxxxxxxxxxxxxxxxxxxxxxxxxxxxxxxxxxxxxxxxxxxxxxxxxxxxxxxxxxxxxxxxxxxx
x++++++++++++++++++++++++++++++++++++++++++++++++++++++++++++++++++++++++++++++++++++++++++++++++++x
x+                                                                                                +x
x+                                                                                                +x
x+                                                                                                +x
x+                                                                                                +x
x+                                                                                                +x
x+                                                                                                +x
x+                                                                                                +x
x+                                                                                                +x
x+                                                                                                +x
x+                                                                                                +x
x+                                                                                                +x
x+               _               _                _               _             _                 +x
x+                                                                                                +x
x+                                                                                                +x
x+                                                                                                +x
x+                                                                                                +x
x+                                                                                                +x
x+                                                                                                +x
x+                                                                                                +x
x+                       >                                               >                        +x
x+                                                                                                +x
x+                                                                                                +x
x+                                                                                                +x
x+                                                                                                +x
x+                                                                                                +x
x+                                                                                                +x
x+                                                                                                +x
x+                               r                                r                               +x
x+               _              d#f               -              d#f            _                 +x
x+                               c                                c                               +x
x+                                                                                                +x
x+                                                                                                +x
x+                                                                                                +x
x+                                                                                                +x
x+                                                                                                +x
x+                                                                                                +x
x+                                                                                                +x
x+                                       <                 <                                      +x
x+                                                                                                +x
x+                                                                                                +x
x+                                                                                                +x
x+                                                                                                +x
x+                                                                                                +x
x+                                                                                                +x
x+                                                                                                +x
x+                                               rrr                                              +x
x+                                              d###f                                             +x
x+               _               -              d#-#f             -             _                 +x
x+                                              d###f                                             +x
x+                                               ccc                                              +x
x+                                                                                                +x
x+                                                                                                +x
x+                                                                                                +x
x+                                                                                                +x
x+                                                                                                +x
x+                                                                                                +x
x+                                                                                                +x
x+                                       <                 <                                      +x
x+                                                                                                +x
x+                                                                                                +x
x+                                                                                                +x
x+                                                                                                +x
x+                                                                                                +x
x+                                                                                                +x
x+                               r                                r                               +x
x+               _              d#f               -              d#f            _                 +x
x+                               c                                c                               +x
x+                                                                                                +x
x+                                                                                                +x
x+                                                                                                +x
x+                                                                                                +x
x+                                                                                                +x
x+                                                                                                +x
x+                                                                                                +x
x+                       >                                               >                        +x
x+                                                                                                +x
x+                                                                                                +x
x+                                                                                                +x
x+                                                                                                +x
x+                                                                                                +x
x+                                                                                                +x
x+                                                                                                +x
x+                                                                                                +x
x+               _               _                _               _             _                 +x
x+                                                                                                +x
x+                                                                                                +x
x+                                                                                                +x
x+                                                                                                +x
x+                                                                                                +x
x+                                                                                                +x
x+                                                                                                +x
x+                                                                                                +x
x+                                                                                                +x
x+                                                                                                +x
x+                                                                                                +x
x+                                                                                                +x
x++++++++++++++++++++++++++++++++++++++++++++++++++++++++++++++++++++++++++++++++++++++++++++++++++x
xxxxxxxxxxxxxxxxxxxxxxxxxxxxxxxxxxxxxxxxxxxxxxxxxxxxxxxxxxxxxxxxxxxxxxxxxxxxxxxxxxxxxxxxxxxxxxxxxxxx
EndOfMapdata
